EA ./textures/wall-EA.xpm
NO ./textures/wall-N.xpm
SO ./path_to_the_south_texture
WE ./textures/wall-W-E.xpm
F 151,150,100
C 50,50,125

 11111
 10W01
 10111
1111 1