  111111
 1100101111111
  101001
111000N1
  111111