
NO      ./textures/wall-N.xpm

SO ./path_to_the_south_texture


WE ./textures/wall-W-E.xpm

    F      151,150,100


   C    50,50,125


EA ./textures/wall-EA.xpm


        1111111111111111111111111
        1000000000110000000000001
        10110000011100000000000S1
        1001000000000000000000001
111111111011000001110000000000001
100000000011000001110111110111111
11110111111111011111000010001
   101       101   1010010001
1111011111 111011111010010011
11000000111101011100000010001
10000000000000001100000000001
10000000000000001101010010001
1100000111010101111101111000111
11110111 1110101 101111010001
11111111 1111111 111111111111